{
	"name": "Spring (It's a Big World Outside)",
	"source": "Stardew Valley OST",
	"reference" : "https://www.youtube.com/watch?v=FO9WXi9gxQg",
	"song": "spring.mp3",
	"timeTravel": 3,
	"wait": 0,
	"period": 3110,
	"content": [
		[0, 0, 0, 0, 0, 0, 0, 0, 0, 0, 0, 0],
		[0, 0, 0, 0, 0, 0, 0, 0, 0, 0, 0, 0],
		[0, 0, 0, 0, 0, 0, 0, 0, 0, 0, 0, 0],
		[1, 0, 0, 1, 0, 1, 1, 0, 1, 0, 1, 0],
		[1, 0, 0, 1, 0, 1, 1, 0, 1, 0, 1, 0],
		[1, 0, 0, 0, 0, 0, 0, 0, 0, 0, 0, 0],
		[0, 0, 0, 0, 0, 0, 0, 0, 0, 0, 0, 0],
		[1, 0, 0, 1, 0, 1, 1, 0, 1, 0, 1, 0],
		[1, 1, 1, 1, 0, 1, 1, 0, 1, 0, 1, 0],
		[1, 0, 0, 0, 0, 0, 0, 0, 0, 0, 0, 0]
	]
}