....S.....
....PP....
.....P....
....PP....
...P.PPPP.
P....P..P.
....PPPPP.
P...P.P...
....P.P...
....PPP...
.P..P.P...
..PPP.P...
....P..P..
....P.P.P.
....PPPPP.
.......PPF