{
	"scene": {
		"fog": {
			"color": "#ccc0ff",
			"near": 40,
			"far": 100
		}
	},
	"sky": {
		"size": 512,
		"gradient": [0, 0, 0, 512],
		"colorStop": [[0, "#331000"], [0.8, "#cc1000"], [1, "#c22211"]]
	},
	"light": {
		"ambient": {
			"color": "#606060"
		},
		"sunlight": {
			"color": "#ffffaa",
			"position": [100, 80, 0]
		}
	},
	"platform": {
		"normal": {
			"edgeRadius": 1.2,
			"texture": {
				"top": "textures/ground_blue.png",
				"others": "textures/ground_blue.png"
			},
			"receiveShadow": true
		},
		"destination": {
			"edgeRadius": 1.2,
			"texture": {
				"top": "textures/undertale_heart.png",
				"others": "textures/undertale_heart.png"
			},
			"receiveShadow": true			
		},
		"decoration": [{
			"edgeRadius": 1.2,
			"texture": {
				"top": "textures/ground_blue.png",
				"others": "textures/ground_blue.png"
			},
			"material": "models/nature_asset.mtl",
			"models": "models/nature_asset.obj",
			"model": 5,
			"size": [6, 15, 6],
			"position": [-2, 3, 6],
			"colorDepth": [10, 10, 10],
			"castShadow": true,
			"receiveShadow": true
		},
		{
			"edgeRadius": 1.2,
			"texture": {
				"top": "textures/ground_blue.png",
				"others": "textures/ground_blue.png"
			},
			"material": "models/nature_asset.mtl",
			"models": "models/nature_asset.obj",
			"model": 18,
			"size": [8, 15, 8],
			"colorDepth": [2, 2, 2],
			"position": [-2.5, 2.5, 0],
			"castShadow": true,
			"receiveShadow": true
		}, 		
		{
			"edgeRadius": 1.2,
			"texture": {
				"top": "textures/ground_blue.png",
				"others": "textures/ground_blue.png"
			},
			"material": "models/nature_asset.mtl",
			"models": "models/nature_asset.obj",
			"model": 8,
			"size": [7, 6, 4],
			"position": [-15, 2, -26],
			"castShadow": true,
			"receiveShadow": true			
		}]
	},
	"stage": [
		[".",".","S",".",".","."],
		[".",".","P",".",".","."],
		[".","P","P",".",".","."],
		[".","P",".",".",".","."],
		["P","P",".",".",".","."],
		["P",".",".",".",".","."],
		["P","P","P","P",".","."],
		[".",".",".","P",".","."],
		[".",".",".","P","P","."],
		[".",".",".",".","P","."],
		[".",".",".",".","P","P"],
		[".",".",".",".",".","P"],
		[".","P","P","P","P","P"],
		[".","P",".",".",".","."],
		[".","P","P","P",".","."],
		[".",".",".","P",".","."],
		[".",".","P","P",".","."],
		[".",".","P",".",".","."],
		[".","P","P",".",".","."],
		[".","P",".",".",".","."],
		[".","P","P","P","P","."],
		[".",".",".",".","P","."],
		[".",".",".","P","P","."],
		[".",".",".","P",".","."],
		[".",".",".","P","P","."],
		[".",".",".",".","P","."],
		[".",".",".","P","P","."],
		[".",".",".","P",".","."],
		[".",".",".","P",".","."],
		[".",".",".","P","P","P"],
		[".",".",".",".",".","P"],
		[".",".",".",".",".","P"],
		[".",".",".","P","P","P"],
		[".",".",".","P",".","."],
		[".",".","P","P",".","."],
		[".","P","P",".",".","."],
		[".","P",".",".",".","."],
		[".","P",".",".",".","."],
		[".","P","P","P",".","."],
		[".",".",".","P","P","."],
		["P","P","P",".","P","."],
		["P",".","P",".","P","."],
		["P",".","P","P","P","."],
		["P","P",".",".",".","."],
		[".","P",".",".",".","."],
		[".","P","P","P",".","."],
		["P","P",".","P",".","."],
		[".",".",".","P",".","."],
		[".","P","P","P",".","."],
		[".","P",".","P",".","."],
		[".","P",".",".",".","."],
		[".","P","P",".",".","."],
		[".",".","P",".",".","."],
		[".",".","P","P",".","."],
		[".",".",".","P",".","."],
		[".",".",".","P","P","."],
		[".",".",".",".","P","P"],
		[".",".",".",".",".","P"],
		[".",".",".",".","P","P"],
		[".",".",".",".","P","."],
		[".",".",".",".","P","P"],
		[".",".",".",".",".","P"],
		[".",".",".",".","P","P"],
		[".",".",".",".","P","."],
		[".",".",".","P","P","."],
		[".",".",".","P",".","."],
		[".",".",".","P",".","."],
		[".",".",".","P",".","."],
		[".",".",".","P","P","P"],
		[".",".",".",".",".","P"],
		[".",".",".",".",".","P"],
		[".",".",".","P","P","P"],
		[".",".",".","P",".","."],
		[".",".","P","P",".","."],
		[".","P","P",".",".","."],
		[".","P",".",".",".","."],
		[".","P",".",".",".","."],
		[".","P","P","P",".","."],
		[".","P",".","P",".","."],
		[".","P",".",".",".","."],
		[".","P","P",".",".","."],
		[".",".","P",".",".","."],
		[".",".","P","P",".","."],
		[".",".",".","P",".","."],
		[".",".",".","P","P","."],
		[".",".",".",".","P","P"],
		[".",".",".",".",".","P"],
		[".",".",".",".","P","P"],
		[".",".",".",".","P","."],
		[".",".",".",".","P","P"],
		[".",".",".",".",".","P"],
		[".",".",".",".",".","P"],
		[".",".",".",".","P","P"],
		[".",".",".",".","P","."],
		[".",".",".","P","P","."],
		[".",".",".","P",".","."],
		[".",".",".","P",".","."],
		[".",".",".","P",".","."],
		[".",".","P","P",".","."],
		[".","P","P",".",".","."],
		[".","P",".",".",".","."],
		[".","P",".",".",".","."],
		[".","P","P","P",".","."],
		[".","P",".","P",".","."],
		[".","P",".",".",".","."],
		[".","P","P",".",".","."],
		[".",".","P",".",".","."],
		[".","P","P",".",".","."],
		[".",".","P",".",".","."],
		[".",".","P","P",".","."],
		[".",".",".","P",".","."],
		[".",".",".","P","P","."],
		[".",".",".",".","P","P"],
		[".",".",".",".",".","P"],
		[".",".",".",".","P","P"],
		[".",".",".",".","P","."],
		[".",".",".",".","P","P"],
		[".",".",".",".",".","P"],
		[".",".",".",".",".","P"],
		[".",".",".",".","P","P"],
		[".",".",".",".","P","."],
		[".",".",".","P","P","."],
		[".",".",".","F",".","."]
	]
}